1111111111111
0111111111110
0011111111100
0001111111000
0000111110000
0000011100000
0000001000000