1111111111111
1011011101101
1100101010011
1100110110011 
1011001001101
1111111111111