11111111100111111111
10000000000000000001
11111111000011111111
10000000000000000001
11111100000000111111
11000000000000000011